***************
* *    *F*S   *
*      * *    *
****     * *  *
*      **  ****
* ******   *  *
* *        *  *
* ******      *
*             *
***************